

NO ./textures/wall1.xpm

NO ./textures/wall1.xpm
WE ./textures/wall3.xpm
EA ./textures/wall4.xpm


C 224,30,0

SO ./textures/wall2.xpm


F 220,100,0

1111
10N1
1111