NO ./textures/wall1.xpm
SO ./textures/wall1.xpm
WE ./textures/wall3.xpm
EA ./textures/wall4.xpm

C 255,255,255
F 220,100,0

1111
10N1
1111