 11111
 10001
 10011
11N01
11111