NO ./textures/wall1.xpm
SO ./textures/wall2.xpm
WE ./textures/wall3.xpm
EA ./textures/wall4.xpm

F 220,100,0
C 224,30,0

 11111
 10001
 1011
10N01
10000
11111