NO ./textures/wall1.xpm
SE ./textures/wall2.xpm
WE ./textures/wall3.xpm
EA ./textures/wall4.xpm

F 220,100,0
C 224,30,0

 11111
 10001
 10011
11N01
10001
11111