1111
1011111111
1000000001
1001111001
1001  1001
1001  1001
1001111001
1000000001
1000011111
100001
100001
10000111111111
11100000000001
  100N00000001
  100000000011
  10000000011
 11000000011
 1111111111